R 800 800
NO assets/guts.xpm
SO assets/grass.xpm
WE assets/metal.xpm
EA        assets/stone.xpm


F       0   ,   250, 0
C 0  , 0 ,  250

S assets/chopper.xpm

1111111111111111
1000000000000001
1000200000020001
1000000000000001
1000000020000001
1000200000000001
10000000N0000001
1000000000000001
1000000000000001
1111111111111111