R 800 800
NO assets/guts.xpm
SO assets/grass.xpm
WE assets/metal.xpm
EA        assets/stone.xpm
S assets/chopper.xpm

F       0   ,   250, 0
C 0  , 0 ,  250

1111111111111111
1000000000000001
1000200000020001
1000000000000001
1000000020200001
1000200202000001
10000220N0200001
1000000000000001
1000000000000001
1111111111111111