R 1920   1080
NO ./path_to_the_north_texture
SO ./path_to_the_south_texture
WE ./path_to_the_west_texture



F       220   ,   100, 0
C 15 ,30,0
EA        ./path_to_the_east_taxture
S ./path_to_the_sprite_texture



11111
10001
10N01
10001
11111