R 1920   1080
NO ./path_to_the_north_texture
SO ./path_to_the_south_texture
WE ./path_to_the_west_texture



F       220   ,   100, 0
C -15 ,30,0

EA        ./path_to_the_east_taxture
S ./path_to_the_sprite_texture



                                  11111111111
111111111111111111111111111111111110000001111111111111
11110111111111011100000010001000000110000111
11110111111111011101010010000000000000000011
11000000110101011100000010001111111111111111
10000000000000001100000010001
10000002000000000001010000001
11000001110101011111011110N01111111111111
11110111 1110101 101111010001
11111111 1111111 111111111111