R 1199 599

NO assets/brown-bricks.xpm

C  0,0,255  

SO assets/blue-bricks.xpm
EA assets/blue-bricks-light.xpm
WE assets/wood-planks.xpm
S assets/chopper.xpm

F 0,    255,    0

11111
10001
1000111111111
1000000S00001
1111111111101
          101
          101
          101
    111111101111111
    100000000000001
    111111101111111
          101
          101
          101
    1111111011111111111111111
    1000000000000000000000001
    1111111111111111100000001
                  11100200001
                  11111111111