R 400 300
NO ./path_to_the_north_texture
SO ./path_to_the_south_texture
WE ./path_to_the_west_texture



F       220   ,   100, 0
C 15 ,30,0
EA        ./path_to_the_east_taxture
S ./path_to_the_sprite_texture



11111111111
10000000001
10000000001
10000000001
10000000001
1N000000001
10000000001
11111111111