R 1500 1000
NO assets/brown-bricks.xpm

C  59,  2,255  
F 0, 255, 255    
SO assets/blue-bricks.xpm
EA assets/blue-bricks-light.xpm
WE assets/wood-planks.xpm
S assets/chopper.xpm


11111
10001
1000111111111
1000000000001
1111111111101
          101
          101
          101
    111111101111111
    100000000000001
    111111101111111
          101
          101
          101
    1111111011111111111111111
    1000000000000000000200001
    11111111111111111000000W1
                  11100200001
                  11111111111