R 1800 1000
NO assets/brown-bricks.xpm

C  0,  0,255  

SO assets/blue-bricks.xpm
EA assets/blue-bricks-light.xpm
WE assets/wood-planks.xpm
S assets/chopper.xpm

F 0,    255,    0

11111
10001
1000111111111
1000200000001
1111111111101
          101
          121
          101
    111111101111111
    100000000000001
    111111101111111
          101
          101
          101
    1111111011111111111111111
    1000000000000000000000001
    11111111111111111000000W1
                  11100200001
                  11111111111