R 800 800
NO assets/guts.xpm
SO assets/grass.xpm
WE assets/metal.xpm
EA        assets/stone.xpm
S assets/shroom.xpm
F       0   ,   255, 0
C 0 , 0 , 255



11111
10001
10N0111111111
1000000000001
1111111111101
          101
          101
          101
    111111101111111
    100000000000001
    111111111111111