R 800 800
NO ./path_to_the_north_texture
SO ./path_to_the_south_texture
WE ./path_to_the_west_texture



F       220   ,   100, 0
C 15 ,30,0
EA        ./path_to_the_east_taxture
S ./path_to_the_sprite_texture

11111
10001
10N0111111111
1000000000001
1111111111101
          101
          101
          101
    111111101111111
    100000000000001
    111111111111111