R 1500 1000
NO assets/brown-bricks.xpm

C  59,  2,255  
F0, 255    , 255    
SO assets/blue-bricks.xpm
EA        assets/blue-bricks-light.xpm
WEassets/wood-planks.xpm
S assets/barrel.xpm


11111       11111111111111
10001       10000011100001
10001111111110000011100001
10000000000000000000000001
11111111111011111111110001
101       101        10001
101       101        10001
101       101        10001
10111111111011111111110001
10000000000000000000000001
11111111111011111111101111
          1000000000001
          1011111111111
          101
    1111111011111111111111111
    1000000000000000000200001
    11111111111111111000000W1
                  11100200001
                  11111111111