R 800 800
NO assets/guts.xpm
SO assets/grass.xpm
WE assets/metal.xpm
EA        assets/stone.xpm
S assets/chopper.xpm
F       0   ,   255, 0
C 0 , 0 , 255


11111111
10000001
10000001
10020001
100N0001
10000001
11111111