R 800 800
NO assets/guts.xpm
SO assets/grass.xpm
WE assets/metal.xpm
EA        assets/stone.xpm
S assets/shroom.xpm
F       0   ,   255, 0
C 0 , 0 , 255


1111111
1000001
1000001
100W001
1000001
1000001
1111111