R 800 800
NO assets/guts.xpm
SO assets/grass.xpm
WE assets/metal.xpm
EA        assets/stone.xpm
S assets/heart32.xpm
F       0   ,   255, 0
C 0 , 0 , 255


11111111111
10000000001
10000000001
10020000001
100N0000001
11111111111