R 800 800
NO assets/guts.xpm
SO assets/grass.xpm
WE assets/metal.xpm
EA        assets/stone.xpm
S assets/chopper.xpm
F       0   ,   255, 0
C 255 , 0 , 0


11111111
10000001
10202001
10020021
100N0201
10000001
11111111